b _ _ _ _ _ _ _ b
b _ _ _ _ _ _ _ b
b _ _ _ _ _ _ _ b
b _ b b b b _ _ b
b _ _ _ _ _ p b b
b _ _ _ _ p b _ b
b _ _ _ p b _ _ b
b _ _ _ b _ _ _ b
b h _ b _ _ _ _ b
b b b b b b b b b