b _ _ _ _ _ _ _ b
b _ _ _ _ _ _ _ b
b _ _ _ _ g _ g b
b _ _ _ b b b b b
b _ _ _ g _ _ _ b
b _ _ b b b b _ b
b _ _ g _ g _ _ b
b _ b b b b _ _ b
b h _ _ _ g _ _ b
b b b b b b b b b