b _ _ _ _ _ _ _ b
b _ _ _ _ _ _ _ b
b _ _ _ r _ _ _ b
b b _ _ _ _ _ b b
b b _ _ _ _ _ b b
b _ b _ _ _ b _ b
b _ b _ _ _ b _ b
b _ _ b _ b _ _ b
b h _ _ _ _ _ _ b
b b b b b b b b b