b _ _ _ _ _ _ _ b
b _ _ _ _ _ _ _ b
b _ _ _ _ r _ _ b
b _ _ _ b _ _ _ b
b _ _ _ _ _ _ _ b
b _ b b _ b b _ b
b p _ _ _ _ _ g b
b b b _ _ _ b b b
b h _ _ _ _ r _ b
b b b b b b b b b