b _ _ _ _ _ _ _ b
b _ _ _ _ _ _ _ b
b p g p g p g p b
b b b b b b b b b
b _ _ _ _ _ _ _ b
b _ _ _ _ _ _ _ b
b _ _ _ _ _ _ _ b
b _ _ _ b _ _ _ b
b h _ b b b _ _ b
b b b b b b b b b