b _ _ _ _ _ _ _ b
b _ _ _ _ _ _ _ b
b _ _ _ _ _ _ p b
b b b p _ _ b b b
b _ _ b _ _ _ _ b
b _ _ _ _ b _ _ b
b _ _ b _ g _ _ b
b _ _ _ _ b _ _ b
b h _ _ _ _ _ p b
b b b b b b b b b